############
############
#####@@P@@##
#####@#@B@##
##+++B#B@###
##+++@B@@@##
####@B@##@##
####@B@@@@##
####@@@@####
############
############
############