############
########@@@#
########@@@#
#+######@B@#
#+######@###
#+BP@@@@@###
#@@###@@B@##
######@@@@##
############
############
############
############