############
###########@
####P@+++##@
####@@@####@
#####B@@@@##
###@@@#B#@##
###@B@#@@@##
###@@@######
############
############
############
############