############
############
############
####@@+#####
###@@+B+B@##
###@B#@#BP##
###@@+@+B@##
###@B#B#####
###@@+@+####
############
############
############