############
#B+B@####P##
#BB@@###@@@#
#BB@@@@@@@@#
#BB@@#@#@@@#
#BB###@#@@@#
####@@@#@@@#
####@@@#@@@#
####@@@@@@@#
####@@##@@@#
############
############