############
############
############
#P@@@@@@@@##
#@####@##@##
#@+@B+B@#@##
#@#@B+B@+@##
#@##@####@##
#@@@@@@@@@##
############
############
############