############
############
####@@+++###
####@P@#####
#####B@@@@##
###@@@#B#@##
###@B@#@@@##
###@@@######
############
############
############
############