############
############
###@@#P@####
###@BBB@####
###@@B@@####
###@BBB@####
###++#++####
###++B++####
############
############
############
############