############
############
############
###@P@@@@@##
###@@++B@@##
##@@#++#####
##@BBB######
##@@@@######
############
############
############
############