############
############
######@P####
####@@B@####
####@#@#####
###@@#@#+###
###@#@@B+###
###@B@@@+###
############
############
############
############