############
############
########@@@#
##@@@#@@B@@#
##@@@B@@#++#
###B@@@B#++#
##@PB#B@#++#
##@@@@@@####
############
############
############
############