############
############
############
####@@@@@###
##@@@###B###
##@B@@B@P@##
###@B@#++@##
###@@@#++###
############
############
############
############