############
############
##@@@##@@###
##@@@B@@@###
##B@###@B###
##@#+++#@###
##@#+++#@###
#PB@@B@@B@##
#@@@#@@@@@##
############
############
############