############
#++@@####P##
#++@@###@@@#
#++@@@@@BB@#
#++@@#@#@B@#
#++###@#@B@#
####@B@#B@@#
####@@B#@B@#
####@B@@B@@#
####@@##@@@#
############
############